boiled = зварене
roast = запечене
baked = випічка
grilled = гриль
fried = посмажене
steamed = приготовлене на пару 
crab = краб
prawns = креветки
salmon = лосось
cabbage = капуста
lemon = лемон
pork = свина
beef = яловичина
lamb = ягня
duck = качка
cucumber = огірок
melon = диня
watermelon = кавун
raspberry = малина
beetroot = буряк
cherry = вишня
grapes = виноград
peach = персик
pear = груша
beans = квасоля
grеen beans = горох
eggplant = баклажан
pepper = перець
raw = сирий
plumbs = сливи
spoon = ложка
fork = вилка
